
 EA  textures/wood.xpm
 WE	textures/grey_stone.xpm
C 68,   142,  226
     SO	textures/color_stone.xpm


F      1,   100,   3
NO   textures/blue_stone.xpm
        1111111111111111111111111
        100000000011000000S000001
        1011000001110000000010101
        1001000000000000000101001
111111111011000001110000000000001
100000000011000001110111111111111
11110111111111011100000010001
11110111111111011101010010001
11000000110101011100000010001
10000000000000001100000010001
10000000000000001101010010001
1100000111010101111101111000111
11110111 1110101 101111010001
11111111 1111111 111111111111
