NO textures/test/north.xpm
SO textures/test/south.xpm
WE textures/test/west.xpm
EA textures/test/east.xpm

F 20,20,20
C 200,200,200

11111111111111111111
1E000000000000000001
11111111111111111111
