NO textures/test/north.xpm
SO textures/test/south.xpm
WE textures/test/west.xpm
EA textures/test/east.xpm

F 20,20,20
C 200,200,200

111111
100001
10E001
100001
111011
101001
110001
100001
110001
101001
100101
101001
111111
