
 WE ./path_to_the_west_texture

C 225,30,0

 NO	./path_to_the_north_texture
 EA      ./path_to_the_east_texture
     SO ./path_to_the_south_texture
F 220,100,0
	



11111111111111111111
10N00000001100000111
11110111111111011101
11110111111111011101
11000000110101011101
11111111111111111111



