
 WE ./path_to_the_west_texture

C 153,153,153

 NO	./path_to_the_north_texture
 EA      ./path_to_the_east_texture
     SO ./path_to_the_south_texture
F 220,100,0

111111111111111
100000100000001
100000100000001
1000001N0000101
100000000001001
100000010000001
100000000000001
101010101000001
100000000000001
111111111111111


